
NO test.png
SO test2.png
EA test3.png
WE testadf   4.png // use ft_strtrim

DO door.png

GU0 gun0.png
GU1 gun1.png
GU2 gun2.png
GU3 gun3.png
GU4 gun4.png
GU5 gun5.png

C 210,210,210
F 40,40,00

    1111111111111
11111100010N01
1111111111111