
NO textures/wall_no.png
SO textures/wall_so.png
EA textures/wall_ea.png
WE textures/wall_we.png

DO textures/door.png

GU0 textures/gun0.png
GU1 textures/gun1.png
GU2 textures/gun2.png
GU3 textures/gun3.png
GU4 textures/gun4.png
GU5 textures/gun5.png


F 40,40,00
C 210,210,210

        11111111111111111111111111111111111111
        10000000001100000000000000000000000001
        101100000111000001H1000011111111111101
        1001000000000000010000001          101
111111110011000001110000010000001          101
1000000000110000011101111111111001         101
11110111111 110111000000V0001  100111111111101
11110111  1111011101010010001   10000000000001
11000000110101011100000010001    1001111111101
100000000000000011000000100011111110111111110111111
100000000000000011010100100000000000000000000000001
11000001110101011111011110N011111111111111111111101
  110111 1110101 101111010001                   101
 1110111 1111111 111111111111111111111111111111110111
1000000010000000100000000000000000000000011000000011011
11111100001111100011011011111111011111110100111110000001
      1011     111 101101      101      1001     1111101
      1001        101 101      1011111110011111111111101
       100111111110111101111111101111110000000000001 101
        100000000000000000000000000000000111110111011001
         1000000000000000000000000000000000000000000001
          11011111111110110111110101111111111111011111
          1100000000000011000000010000000000000001
           11111111111111111111111111111111111111