NO textures/wall_no.png
SO textures/wall_so.png 
EA textures/wall_ea.png
WE textures/wall_we.png

DO textures/door.png

GU0 textures/gun0.png
GU1 textures/gun1.png
GU2 textures/gun2.png
GU3 textures/gun3.png
GU4 textures/gun4.png
GU5 textures/gun5.png

F 50,50,50
C 100,40,40


11111111111111111111111111111111111111111111
111111111111E0000000010000000000111111111111
11111111111100000000111000000000111111111111
11111111111100000111111111100000111111111111
11111111111100000000111000000000111111111111
111111111111000000000V0000000000111111111111
11111111111100000000111000000000111111111111
11111111111100000111111111100000111111111111
11111111111100000000111000000000111111111111
11111111111100000000010000000000111111111111
11111111111111111111111111111111111111111111